-----------------------------------------
-------------------------------------9---
------------------------------------9----
----------------------------------99-----
---------------------------------9--9----
--------------------------------9--------
-------------------------------9---9-----
------------------------------9----------
----------------------------99-----------
---------------------------9------9------
------11111---------------9--------------
-----1-----1-------------9---------------
----1-------1-----------9--------9-------
----------------------99-----------------
---------------------9-------------------
---1---------1------9-----------9--------
---------------------99------------------
-----------------------99------9---------
----1-------1------------99--------------
-----1-----1---------------99------------
------11111-----444----------99----------
---------------4---4---------------------
-----------------------------------------
-3333---------4-----4--------------------
-3--3---------------------------777777---
-3--3----------4---4------------7----7---
-3--3-----------444-------------7----7---
-3--3-----222222222-------------7----7---
-3333-----2-------2-------------7----7---
----------2-------2-------------7----7---
----------222222222-------------777777---
-----------------------------------------
-----------------------------------------
----------------------------6------------
------55-------------------6-66----------
-----5--555--------------66----6---------
----5------55-----------6-------66-------
---5---5555------------6----------6------
--55555--------------66------------66----
-55-----------------666666666666666666---
-----------------------------------------
